OOOOOOOOEOOOOOOOO
BBBBBBBBWBBBBBBBB
BOOOOOOOOOOOOOOOB
BBBBBBBBWBBBBBBBB
OOOOOOOOWOOOOOOOO
OOOOOOBBWBBOOOOOO
OOOOOOBOOOBOOOOOO
OOOOBBWBBBWBBOOOO
OOOOBOOOOOOOBOOOO
OOBBBBBBBBBBBBBOO
OOBOOOBOOOBOOOBOO
WBBBWBBBWBBBWBBBW
BOOOBOOOBOOOBOOOB
BBSBBBSBBBSBBBSBB
